88888888888888888888888888888888888888888888888888888888888888888888888888888888888888888888888888888888888888888888888888888888
80000000000000000000000000000000000000000000000000333333333333333333333333333333333333333333333333333333333333333333333333333338
80000000000000000000000000000000000000000000000000300000000000088000000000000800000000000000000007000000000000080000000000000838
80000003433000000000000000000000000848000000000000300000000008700000000000000080000000000000000008800000000000800000000000000838
80000044003800000000000000004443338008880000000000300000008888880000000000000008000000000000000008088000000000800000000000008038
80000880000440000000000000443000000000088000000000300000878000008888888880000000800000000000000008000800000000800000000000080038
80003300000004000000000000300000000000000800000000300008000800000000000008888800080000000000000008000070000000800000000000080038
80004000000000400000000008000000888880000800000000300880000800000000000000000800007000878000000088000008000008000000000000800038
80008000334000440000000040000033300030003300000000388000000800000000000000000800008888080000000808000000800008000000000000800038
80008000403400044400008300003330000080040000000000300000000800000000000000000808880000080000008008000000088008000000000007000038
80003000800800000444430004433008333830400000000000300000000080000000080000000080000000800000008008000000000880000000000080000038
80004300430340000000000444033833000330400000000000380000000080000008880000000080000008000000080008000000000080000000000080000038
80000400034033300000033404480000000330400000000000308000000080000080008000000080000008000000800008000080000880000000000800000038
80000800003300344484430044000444440880033000000000300800000080008800008000000080000088888888000008000780008008700000008000000038
80000880000033000000000800083000040388000833338488300088000007880000000800000080000000000000000008088070080000088000008000000038
80000044444004883400008004400000040088800000000000300000800008000000000800000080000000000000000008800800800000000880080000000038
80000000004300000330480084000000030033300000334300300000080000000000000800000808000000000000000088000708000000008008800000000038
80000000000034000088000480000000030003330033300330700000008000000000000080008000880000000000000800000880000000080000088000000038
80000000000004300000043800000000040000034330000038300000000880000000000080080000008000000000008000008000000000800000000780000038
80000000000000033848430000000000088000000000438000300000000808800000000008800000000800000000080000080000000008000000000008800038
80000000000000000000000000000000008840000004803300300000007000088000000080000000000080000008700000800000000008000000000000088038
80000000000000000000000000000000000088344880000300388000080000000880000800000000000008700080000008000000000070000000000000000838
80000004484000000000000000000833800000000000000300300888888000000008708000000000000000080800000080000000000800000000880000000038
80000034000430000000000000004400080000000000000400300000000888888000080000000000000000088888888888880000008000008878008000000838
80000030000083380000000000008000048000000000004408300000000000000888887000888888888888800000000088007000080008880000008000000838
80000330000000008834443000083000004800000000004008300000000000000000000888000000000000000000008800000800088880000000000800008038
80000300033388000000004348380033300038000000040008300888880000000000000008000000000000000000070000000088800000000000000800007038
80000300080008833000000000000430033000380003400008300800008888888800000080800000000000000008800000000008000000000000000080080038
80000800008000003333333400004300008300003344000048300800000000000088888080087000000000000880000000880000800000000000000080800038
80000030008833000000000433434000000333400000003340308000000000000000000800000800000000088000008888080000080000000000000008800038
80000033000000333333300000000000000000334333343000308000000000000000000800000080000000800088880000808000008000000000008808000038
80000008843430000000330000000034444333300000000000308000000000000000007000000008800000888800000008000800000800000000880088000038
80000000000008480000088848484440000000880000000000308000000000000000008000000000088888000000000008000088000080000078000000800038
80000000000000084000000000000000000000034888000000308000000000000000080000000008880000000000000080000000800008088800000000070038
80000000000000008434438483438384888340000003300000370000000000000000880000000088000000000000007700000000080008800000000000008838
80000000000000000000000000000000000083880000340000380000000000000088080000000800800000000000880800000000008880000000000080000038
80000000000000000000000000000000000000038400040000380000000000008800008000008000800000000008000080000000078000000000008808000038
80000000000000000000000000000000000000000800040000380000000008880000008000080000800000000880000080000000808000000000880000800038
80000000000000000000000000000000000000000080004000380000000880000000008000080000080000008000000008000008008000000088000000080038
80000000000000000000000000000000000000000080003000300000888000000000008000800000080000880000000000800008000800008700000000080038
80000000000000334444300000000000000000000008003000300088000000000000000808000000080008000000000000080080000700880000000000008038
80000000000008000000344888000000000000000008008000308800000000000000000880000000008880000000000000080800000888000000000000000838
80000000000030000000000000443300000000000008003300380000000000000000000800000000008000000000000000008000000800000000000000000078
80000000000088000000000000000038400000000083000800373333333333333333333733333333337333333333333337333333333733333337333333333378
80000000000003000000000000000000083848383830003300300000003000003000000000030000000003000000000000003000000000300000000030000078
80000000000000380000000333344000000000000000033000300000003000003000000000030000000003000000000000003000000000300000000030000038
80000000000000004000000300003433430008888344440000300000003000003000000000030000000003000000000000003000000000300000000030000038
80000000000000000300000030000000044844000000000000300000003000003000000000030000000003000000000000003000000000300000000030000038
80000000000000000040000030000000000000000000000000300000003000003000000000030000000003000000000000007000000000300000000030000038
80000000000000000004400004400000000000000000000000300000003000003000000000030000000007000000000000003000000000300000000030000038
80000000000000000000440000334800000000000000000000300000003000003000000000030000000003000000000000003000000000300000000030000038
80000000000000000000004000000443334344834434400000333333373333777333733333333337333333333333333333333337333333333333333333333338
80000000000000000000000840000000000000000000400000300003000000003000000003000000003000000000300000000000300000003000000000000338
80000000000000000000000004330000000000000000400000300003000000003000000003000000003000000000300000000000300000003000000000000338
80000000000000000000000000003400000000000000400000300003000000003000000007000000003000000000300000000000700000003000000000000338
80000000000000000000000000000083000000000004000000300007000000003000000003000000003000000000300000000000300000003000000000000338
80000000000000000000000000000000880000000004000000300003000000003000000003000000007000000000300000000000300000003000000000000338
80000000000000000000000000000000034000000008000000300003000000003000000003000000003000000000300000000000300000003000000000000338
80000000000000000000000000000000000880000044000000300003000000003000000003000000003000000000300000000000300000003000000000000338
80000000000000000000000000000000000088000040000000300003000000003000000003000000003000000000300000000000300000003000000000000338
80000000000000000000000000000000000088000040000000333733333333333373333333373333333333333373333333333333373333333337333333337338
80000000000000000000000000000000008800000440000000300000000070000000030000003000000000030000000030000000003000000000300000000038
80000000000000000000000000000038830000000400000000300000000030000000030000003000000000030000000030000000003000000000300000000038
80000000000000000000000000004800000000000400000000300000000030000000030000003000000000030000000030000000003000000000300000000038
80000000000000000000000088434000000000004400000000300000000030000000070000003000000000030000000030000000003000000000300000000038
80000000000000000000044400000000000000340000000000300000000030000000030000007000000000030000000030000000007000000000300000000038
80000000000000000044400000000000000033000000000000300000000030000000030000003000000000070000000030000000003000000000300000000038
80000000000000000430000000000000000430000000000000300000000030000000030000003000000000030000000030000000003000000000300000000038
80000000000000084000000000000000033000000000000000300000000030000000030000003000000000030000000030000000003000000000300000000038
80000000000000080000000000000033800000000000000000333733333333333333333333333337333333333333333333333333333333333333333333337338
80000000000000030000000000008300000000000000000000300000300000000030000000030000030000300000003000000000300000000000030000000038
80000000000000034000000000003000000000000000000000300000300000000030000000030000030000300000007000000000300000000000030000000038
80000000000000000430000000000300000000000000000000300000300000000030000000030000033373334744444444744444400000000000030000000038
80000000000000000008000000000040000000000000000000300000700000000030000000030000030000004000000000000000700000000000444444744448
80000000000000000008300000000004000000000000000000300000300000000030000000070000030000004000000000000000400000000000400000000048
80000000000000000000830000000008400000000000000000300000300000000030000000030000030000004000000000000000400000000000400000000048
80000000000000000000003000000000380000000000000000300000300000000030000000030000030000004000000004444444444000000000400000000048
80000000000000000000000400000000033000000000000000300000300000000070000000030000030000007000000004000000004000000000400000000048
80000000000000000000000040000000003300000000000000300000300000000030000000030000030000004000000004000000004444744444444400000048
80000000000000000000000008000000000300000000000000300000300000000030000000030000030444444444000004000000004000000000000400000048
80000000000000000000000000800000000840000000000000333333333333333333333333333333337400000004000004000000004000000000000400000048
80000000034000000000000000038000000040000000000000300000003000000000300000000000000400000004000004000000004000000000000400000048
80000000040800000000000000008400000030000000000000300000003000000000300000000000000400000004000004000000004000004444444444444778
80000000440300000000000000000480000030000000000000300000003000000000300000000000000400000004000004000000007000004000000000044478
80000000400030000000000000000008000033000000000000300000007000000000300000000000000400000004000004000000004000004000000000047778
80000004000030000000000000000000300003000000000000300000003000000000300000000000000400000004000004000000004000004000000000044748
80000003000040000000000000000000040004000000000000300000003000000000300000000000000400000004447444444000004000004000000000044748
80000040000003000000000000000000003300440000000000300000003000000000300000000000000400000004000000004000004000004000000000044778
80000080000004000000000000000000000080003400000000300000003000000000300000000004444444474444000000004000004000004000000000047478
80000300400003000000000000000000000008300880000000333333333333333333333333733334000000000004000000004447444444444444000000077478
80004400440000400000000000000000000000330038000000300000003000000000300000000004000000000004000000004000000000000004000000047778
80043000040000400000000000000000000000030003000000300000003000000000300000000004000004447444440000004000000000000004000000047478
80048000080000400000000000000000000008330088000000300000003000000000300000000004000004000000040000004000000000000004000000447748
80004000004000080000000000000000343380000030000000300000003000000000300000000004000004000000040000004000000000000004000000400048
80003400004000030000000084334838000000000330000000300000007000000000300000000004000004000000040000004000000000000444444444400048
80000300000400080008838300000000000000043300000000300000003000000000300000444444444444000000040000044444444444400700000000400048
80000030000400003880000000000000383388443000000000300000003000000000300000400000000004000000040000070000000000400400000000400048
80000033000430003000000000083483300000008300000000300000003000000000300000400000000004000000040000040000000000400400000000700048
80000003000044000000004438380000000000000800000000444474444000000000300000400000000004000000044444440000004447444444444400400048
80000000800003484343334000000000000438000040000000400000004444444474444744400000000004000000070000070000004000000000000447444048
80000000040000000000000000038888888003830033000000400000004000000000000000400000044444444474440000044444444000000000000400004048
80000000040000000000003434430000000000033004400000400000004000000000000000400000040000000000040000000000004000000000000400004048
80000000004343343383380000000000000000008800400000400000007000000000000000400000040000000000040000000000004000000000000400004048
80000000000000000000000000000000000000000800430000400000004000000004444444447400040000000000040000000000004000000000000400004048
80000000000000000000000000000000000000000830030000400000004000000004000000000400040000000474440000000044474400000000000400004048
80000000000000000004843834000000000000000030030000400044444444440007000000000400040000000400040000000040000400000000000400004048
80000000000000000838000004300000000000000030030000400040000000070004000000444444444000000400044474444440000400000000000400004048
80000000000000000400000000040000000000000800040000400040000000040004000000400000004000000400000000400040000400000000000400004048
80000000000000008000000000043000000000000800430000400040000444444744400000700000004444444400000000400070000444444474444400004048
80000000000000003000000000003000000000003800400000400040000400000000400000400000004000000400000000400040000004004000004000004048
80000000000000080000033300003000000000008000400000400040000400000000400000400000004000000700000000400040000404004000004000004048
80000000000000080000030300004400000000080003400000400040000400000000400000400000004000000400000000400040000400004000004444444748
80000000000000830000030300000400000000080003000000400040000400000000400000400000004000000400004444400040000400004000004000000048
80000343300008800000000000000830000000300034000000437444744400000000400000400000004044444400004000474440000444444000004000000048
80083000044840000000000000000030000043300340000000400000000400000000404444444444444740000444444000000040000400400000004000000048
80880000000000000443000000000080000400003300000000400000000400000000704000000000000040000000004000000044447400400000004000000048
80300000000000000473400000000038833000333000000000400000004444444444444000000000000040000000004000000000040000700000004000000048
80800000000000000777400000000000080000300000000000400000004000000000007000000000000040000000004000000000040000400000004000000048
80800000000000000337740000000000000034800000000000400000004000000444444000000000000040000000444000000000040000400000004000000048
80030000000000008733733000000000443330000000000000400000007000000400004000000000000070000000404000000000040000444444444000000048
80030000000000438737733300000088400000000000000000400000004000000400007000000000000040000000404444444474440000004000004000000048
80004000000048783733777400008380000000000000000000400000004000000400004000000004444440000000400000004000040000004000007000000048
80000300000347777777734383038000000000000030003000400000004000000400004000000004000040000000400000004000044444444000004000000048
80000334083487333344777773480000003030300303030300400000004000000400004444444444000044444444400000004000000000040000004444447448
80000004800000000004433383400000003030000000000000444444444000000400000004444444000000000000400000004000000000070000000000000048
80000000000000000000000000400000003330300003030000444444444000000444444444444444000000000000400000004000000000040000000000000048
80000000000000000000000000400000003030300000300000444444444444444444444444444444444444444444444444444444444444444444444444444448
88888888888888888888888888888888888888888888888888888888888888888888888888888888888888888888888888888888888888888888888888888888