88888888888888888888888888888888888888888888888888888888888888888888888888888888888888888888888888888888888888888888888888888888
80000000000000033333333300000000000000000000000000000000000000000000000000000000000000333330000000000000000000000003333333333338
80000000000000030000000300000000000000000000000000000000000000000000000000000000000000300030000000000000000000000003000000000038
80000000000000030000000300000000000000000000000000000000000000000000000000000000000000300030000000000000000000000003000000000038
80000000000333330090000300000000000000000000000000000000000000000000000000000000000000300030000000000000000000000003000000000038
80000000000300000000000300000000000000000000000033333333333000000000000000000000000000300030000000000000000000000003000000000038
80000000000300000033333300000000000000000000000030000000003000000000000000000000000000303030000000000000000000000003000000000038
80000000000300000030000000000000000000000000000030000000003000000000000000000000000000300030000000000000000000000003000000090038
80000000000333373330000000000000000000000000000030000000003000000000000000000000000000700030000000000000000000000003337333000038
80000000000000000000000000000000000000000000000030000000003000000000000000000000000000300030000000000000000000000000000003000038
80000000000000000000000000000000000000000000000033333000007000000000000000000000000000333330000000000000000000000000000003000038
80000000000000000000000000000000000000000000000000003000003000000000000000000000000000000000000000000000000000000000000003000038
80000000000000000000000000000000000000000000000000003000003000000000000000000000000000000000000000000000000000000000000003333338
80000000000000000000000000000000000000000000000000003333333000000000000000000000000000000000000000000000000000000000000000000008
80000000000000000000000000000000000000000000000000000000000000000000000000000000000000000000000000000000000000000000000000000008
80000000000000000000000000000000000000000000000000000000000000000000000000000000000000000000000000000000000000000000000000000008
80000000000000000000000000000000000000000000000000000000000000000000000000000000000000000000000000030000000300000000000000000008
80000000000000000000000000000000000000000000000000000000000000000000000000000000000000000000000000003000003000000000000000000008
80000000000000000000000000000000000000000000000000000000000000000000000000000000000000000000000000000300030000000000000000000008
80000000000000000000000000000000000000000000000000000000000000000000000003333333330000000000000000000030300000333300000000000008
80000000000000000000000000000000000000000000000000000000000000000000000003000000030000000000000000000003000000000000003000000008
80000000000000000000000000000000000000000000000000000000000000000000000003000000030000000000000000000030300000333300000000000008
80000000000000000000000000000000000000000000000000000000000000000000000003000000030000000000000000000300030000000000000000000008
80000000000000000000000000000000000000000000000000000000000000000000000003000900030000000000000000003000003000000000000000000008
80000000000000000000000000000000000000000000000000000000000000000000000007000000030000000000000000030000000300000000000000000008
80000000000000000000000000000000000000000000000000000000000000000000000003000000030000000000000000000000000000000000000000000008
80000000000000000000000000000000000000000000000000000000000000000000000003333333330000000000000000000000000000000000000000000008
80000000000000000000000000000000000000000000000000000000000000000000000000000000000000000000000000000000000000000000000000000008
80000000000000000000000000000000000000000000000000000000000000000000000000000000000000000000000000000000000000000000000000000008
80000000000000000000000000000000000000000000000000000000000000000000000000000000000000000000000000000000000000000000000000000008
80000000033330003333300000000000000000000000000000000000000000000000000000000000000000000000000000000000000000000000000000000008
80000000030030003000300000000000000000000000000000000000000000000000000000000000000000000000000000000000000000000000000000000008
80000000030030003030300000000000000000000000000000000000000000000000000000000000000000000000000000000000000000000000000000000008
80000000070030003000300000000000000000000000000000000000000000000000000000000000000000000000000000000000000000000000000000000008
80000000030033333030300000000000000000000000000000000000000000000000000000000000000000000000000000000000000000000000000000000008
80000000030000000000300000000000000000033300300303000300000000000000000000000000000000000000000000000000000000000000333333300008
80000000030000000900300000000000000000030030300303300300000000000000000000000000000000000000000000000000000000000000300000300008
80000000030000000000300000000000000000030030300303030300000000000000000000000000000000000000000000000000000000000000300000300008
80000000033333333333300000000000000000033300300303003300000000000000000000000000000000000000000000000000000000000000300300300008
80000000000000000000000000000000000000030030300303000300000000000000000000000000000000000000000000000000000000000000300090300008
80000000000000000000000000000000000000030030333303000300000000000000000000000000000000333330000000000000000000000000300000333308
80000000000000000000000000000000000000000000000000000000000000000000000000000000000000300030000000000000000000000000300000700308
80000000000000000000000000000000000000000000000000000000000000000000000000000000000000300030000000000000000000000000333333300308
80000000000000000000000000000000000000000000000000000000000000000000000000000000000000300030000000000000000000000000000000300308
80000000000000000000000000000000000000000000000000000000000000000000000000000000033373300030000000000000000000000000000333373338
80000000000000000000000000000000000000000000000000000000000000000000000000000000030000000030000000000000000000000000000300000038
80000000000000000000000000000000000000000000000000000000000000000000000000000000030000000030000000000000000000000003333303000038
80000000000000000000000000000000000000000000000000000000000000000000000000000000030000000030000000000000000000000007000000000038
80000000000000000000000000000000000000000000000000000000000000000000000000000000030000000030000000000000000000000003000000000038
80000000000000000000000000000000000000000000000000000000000000000000000000000000030000000030000000000000000000000003333303000038
80000000000000000000000000000000000000000000000000000000000000000000000000000000033333333330000000000000000000000000000300000038
80000000000000000000000000000000000000000000000000000000000000000000000000000000000000000000000000000000000000000000000300000038
80000000000000000000000000000000000000000000000000000000000000000000000000000000000000000000000000000000000000000000000303003038
80000000000000000000000000000000000000000000000000000000000000000000000000000000000000000000000000000000000000000000000300000038
80000000000000000000000000000000000000000000000000000000000000000000000000000000000000000000000000000000000000000000000333333338
83333000000000000000000000000000000000000000000000000000000000000000000000000000000000000000000000033330000000000000000000000008
83003000000000000000000000000000000000000000000000000000000000000000000000000000000000000000000000030000000000000000000000000008
83003333333000000000000000000000000000000000000000000000000000000000000000000000000000000000000000030333300000000000000000000008
83000000003000000000000000000000000000000000000000000000000000000000000000000000000000000000000000030300000000000000000000000008
83000000003000000000000000000000000000000000000000000000000000000000000000000000000000000000000000030300000000000000000000000008
83000000003000000000000000000000000000000000000000000000000333333333000000000000000000000000000000030333333000000000000000000008
83000033733000000000000000000000000000000000000000000000000300000003000000000000000000000000000000030000000000000000000000000008
83000030000000000000000000000000000000000000000000000000000300000003000000000000000000000000000000030333333000000000000000000008
83003030000000000000000000000000000000000000000000000000000300000003000000000000000000000000000000030300000000000000000000000008
83000030000000000000000000000000000000000000000000000000000300000007000000000000000000000000000000030300000000000000000000000008
83000030000000000000000000000000000000000000000000000000000300000003000000000000000000000000000000030333333000000000000000000008
83333330000000000000000000000000000000000000000000000000000333333333000000000000000000000000000000030000000030000000000000000008
80000000000000000000000000000000000000000000000000000000000000000000000000000000000000000000000000033333333330000000000000000008
80000000000000000000000000000000000000000000000000000000000000000000000000000000000000000000000000000000000000000000000000000008
80000000000000000000000000000000000000000000000000000000000000000000000000000000000000000000000000000000000000000000000000000008
80000000000000000000000000000000000000000000000000000000000000000000000000000000000000000000000000000000000000000000000000000008
80000000000000000000000000000000000000000000000000000000000000000000000000000000000000000000000000000000000000000000000000000008
80000000000000000000000000000333000000000000000000000000000000000000000000000000000000000000000000000000000000000000000000000008
80000000000000000000000000003000300000000000000000000000000000000000000000000000000000000000000000000000000000000000000000000008
80000000000000000000000000003000300000000000000000000000000000000000000000000000000000000000000000000000000000000000000000000008
80000000000000000000000000000000300000000000000000000000000000000000000000000000000000000000000000000000000000000000000000000008
80000000000000000000000000000003000000000000000000000000000000000000000000000000000000000000000000000000000000000000000000000008
80000000000000000000000000000030000000000000000000000000000000000000000000000000000000000000000000000000000000000000000000000008
80000000000000000000000000000000000000000000000000000000000000000000000000000000000000000000000000000000000000000000000000000008
80000000000000000000000000000030000000000000000000000000000000000000000000000000000000000000000000000000000000000000000000000008
80000000000333333300000000000000000000000000000000000000000000000000000000000000000000000000000000000000000000000000000000000008
80000000000300000300000000000000000000000000000000000000000000000000000000000000000000000000000000000000000000000000000000000008
80000000000303333300000000000000000000000000000000000000000000000000000000000000000000000000000000000000000000000000000000000008
80000000000303000000000000000000000000000000000333333330000000000000000000000000000000000000000000003333333330000000000000000008
80000000000303333000000000000000000000000000000300090030000000000000000000000000000000000000000000003000000030000000000000000008
80000000000300093000000000000000000000000000000300000030000000000000000000000000000000000000000000003000000030000000000000000008
80000000000303333000000000000000000000000000000300330030000000000000000000000000000000000000000000003000000030000000000000000008
80000000000303000000000000000000000000000000000300000030000000000000000000000000000000000000000000007000000033333333300000000008
80000000000303000000000000000000000000000000000300000030000000000000000000000000000000000000000000003000000000000000300000000008
80000000000303000000000000000000000000000000000300337330000000000000000000000000000000000000000000003000000000000300300000000008
80000000000373000000000000000000000000000000000300300000000000000000000000000000000000000000000000003000000000000000300000000008
80000000000000000000000000000000000000000000000300300000000000000000000000000000000000000000000000003000000000000300300000000008
80000000000000000000000000000000000000000000000300300000000000000000000000000000000000000000000000003333333300000000300000000008
80000000000000000000000000000000000000000000000333300000000000000000000000000000000000000000000000000000000333333000300000000008
80000000000000000000000000000000000000000000000000000000000000000000000000000000000000000000000000000000000000003333300000000008
80000000000000000000000000000000000000000000000000000000000000000000000000000000000000000000000000000000000000000000000000000008
80000000000000000000000000000000000000000000000000000000000000000000000000000000000003000300000000000000000000000000000000000008
80000000000000000000000000000000000000000000000000000000000000000000000000000000000030303030000000000000000000000000000000000008
80000000000000000000000000000000000000000000000000000000000000000000000000000000000000000000000000000000000000000000000000000008
80000000000000000000000000000000000000000000000000000000000000000000000000000000000000303000000000000000000000000000000000000008
80000000000000000000000000000000000000000000000000000000000000000000000000000000000000030000000000000000000000000000000000000008
80000000000000000000000000000000000000000000000000000000000000000000000000000000000000000000000000000000000000000000000000000008
80000000000000000000000000000000000000000000000000000000000000000000000000000000000000000000000000000000000000000000000000000008
80003373333000000000000000000000000000000000000000000000000000000000000000000000000000000000000000000000000000000000000000000008
80003000003000000000000000000000000000000000000000000000000000000000000000000000000000000000000000000000000000000000000000000008
80003000003000000000000000000000000000000000000000000000000000000000000000000000000000000000000000000000000000000000000000000008
80003000003000000000000000000000000000000000000000000000000000000000000000000000000000000000000000000000000000000000000000000008
80003009003000000000000000000000000000000000000000000000000000000000000000000000000000000000000000000000000000000000000000000008
80003000003000000000000000000000000000000000000000000000000000000000000000000000000000000000000000000000000000000000000000000008
80003333333000000000000000000000000000000000000000000000000000000000000000000000000000000000000000000000000000000000000000000008
80000000000000000000000000000000000000000000000000000000000000000000000000000000000000000000000000000000000000000000000000000008
80000000000000000000000000000000000000000000000000000000000000000000000000000000000000000000000000000000000000000000000000000008
80000000000000000000000000000000000000000000000000000000000000000000000000000000000000000000000000000000000000000000000000000008
80000000000000000000000000000000000000000000000000000000000000000000000000000000000000000000000000000000000000000000000000000008
80000000000000000000000000000000000000003333333333333330000000000000000000000000000000000000000000000000000000000000000000000008
80000000000000000000000000000000000000003000000000000030000000000000000000000000000000000000000000000000000000000000000000000008
80000000000000000000000000000000000000003000000000000030000000000000000333333300000000000000000000000000000000000000000000000008
80000000000000000000000000000000000000003000300030000030000000000000000300000300000000000000000000000000000000000000000000037338
80000000000000000000000000000000000000003000000000000030000000000000000300000300000000000000000000000000000000000000000003300038
80000000000000000000000000000000000000003000000000000030000000000000000300000700000000000000000000000000000000000000000330000038
80000000000000003333300000000000000000003000003000000030000000000000000300900300000000000000000000000000000000000000033000003338
80000000000000003000300000000000000000003000000000000030000000000000000300000330000000000000000000000000000000000003300000330008
80000000000000003000333333000000000000003000000000000030000000000000000300000030000000000000000000000000000000000330000033000008
80000000000000007000000003000000000000003000000000000070000000000000000333300030000000000000000000000000000000033000000030000008
80000000000000003000009003000000000000003000000000000030000000000000000000300030000000000000000000000000000003300000300003300008
80000000000000003000000003000000000000003000000000000030000000000000000000333330000000000000000000000000000003009000000000033008
80000000000000003333333333000000000000003333333333333330000000000000000000000000000000000000000000000000000003333333333333333308
88888888888888888888888888888888888888888888888888888888888888888888888888888888888888888888888888888888888888888888888888888888